Beyond the Great Wall	The Rising Stones	60
Lyse Takes the Lead	The Fringes	60
The Promise of a New Beginning	Rhalgr's Reach	60
A Haven for the Bold	Rhalgr's Reach	60
A Bargain Struck	Rhalgr's Reach	60
A Friend of a Friend in Need	Rhalgr's Reach	60
Signed, Sealed, to Be Delivered	The Fringes	60
Best Served with Cold Steel	The Fringes	60
Let Fill Your Hearts with Pride	The Fringes	60
A Familiar Face Forgotten	Rhalgr's Reach	60
The Prodigal Daughter	The Peaks	60
Hard Country	The Peaks	60
Death by a Thousand Rocks	The Peaks	60
A Life More Ordinary	The Peaks	60
The Color of Angry Qiqirn	The Peaks	60
The Black Wolf's Pups	The Peaks	60
Homeward Bound	The Peaks	60
Where Men Go as One	Rhalgr's Reach	60
Future Rust, Future Dust	Rhalgr's Reach	60
A Dash of Green	Rhalgr's Reach	60
Ye Wayward Brothers	Rhalgr's Reach	60
Token of Faith	Rhalgr's Reach	60
Crossing the Velodyna	Rhalgr's Reach	61
In Crimson It Began	The Fringes	61
The Fires Fade	Rhalgr's Reach	61
Bereft of Hearth and Home	Rhalgr's Reach	61
Divide and Conquer	Rhalgr's Reach	61
Lies, Damn Lies, and Pirates	The Fringes	61
Tales from the Far East	Limsa Lominsa	61
Not without Incident	Mor Dhona	61
The Man from Ul'dah	Kugane	61
Where the Streets Are Paved with Koban	Kugane	61
By the Grace of Lord Lolorito	Kugane	61
A Good Samurai Is Hard to Find	Kugane	61
It's Probably a Trap	Kugane	61
Making the Catfish Sing	Kugane	61
Once More, to the Ruby Sea	Kugane	62
Open Water	The Ruby Sea	62
Boys with Boats	The Ruby Sea	62
To Bend with the Wind	The Ruby Sea	62
Confederate Consternation	The Ruby Sea	62
The Solace of the Sea	The Ruby Sea	62
The Arrows of Misfortune	The Ruby Sea	62
The Last Voyage	The Ruby Sea	62
Alisaie's Stones	The Ruby Sea	62
Under the Sea	The Ruby Sea	62
Of Kojin and Kami	The Ruby Sea	62
In Soroban We Trust	The Ruby Sea	63
Forever and Ever Apart	The Ruby Sea	63
In Darkness the Magatama Dreams	The Ruby Sea	63
The Whims of the Divine	The Ruby Sea	63
Breaking and Delivering	The Ruby Sea	63
The Lord of the Revel	The Ruby Sea	63
Tide Goes in, Imperials Go Out	The Ruby Sea	63
A Silence in Three Parts	The Ruby Sea	63
Life after Doma	Yanxia	64
A Glimpse of Madness	Yanxia	64
The Stubborn Remainder	Yanxia	64
The Ones We Leave Behind	Yanxia	64
A New Ruby Tithe	Yanxia	64
The Will to Live	Yanxia	64
Daughter of the Deep	Yanxia	64
Path of No Return	Yanxia	64
The Time between the Seconds	Yanxia	64
All the Little Angels	Yanxia	64
Here There Be Xaela	Yanxia	65
The Search for Lord Hien	The Azim Steppe	65
A Season for War	The Azim Steppe	65
An Impossible Dream	The Azim Steppe	65
Stars in the Dark	The Azim Steppe	65
A Warrior's Welcome	The Azim Steppe	65
The Heart of Nations	The Azim Steppe	65
A Trial Before the Trial	The Azim Steppe	65
In the Footsteps of Bardam the Brave	The Azim Steppe	65
The Children of Azim	The Azim Steppe	65
The Labors of Magnai	The Azim Steppe	66
For Love of the Moon	The Azim Steppe	66
Sworn Enemies of the Sun	The Azim Steppe	66
The Undying Ones	The Azim Steppe	66
A Final Peace	The Azim Steppe	66
As the Gods Will	The Azim Steppe	66
Naadam	The Azim Steppe	66
Glory to the Khagan	The Azim Steppe	66
In Crimson They Walked	The Azim Steppe	66
The Hour of Reckoning	The Azim Steppe	66
The Room Where It Happened	Yanxia	67
How Tataru Got Her Groove Back	Kugane	67
Seeds of Despair	Yanxia	67
The Limits of Our Endurance	Yanxia	67
Broken Steel, Broken Men	Yanxia	67
The Doma Within	Yanxia	67
On the Eve of Destiny	Yanxia	67
The Die Is Cast	Yanxia	67
The World Turned Upside Down	Yanxia	67
A Swift and Secret Departure	Kugane	67
While You Were Away	Limsa Lominsa	67
Rhalgr's Beacon	The Fringes	67
The Fortunes of War	The Fringes	67
Rising Fortunes, Rising Spirits	The Fringes	67
The Lure of the Dream	The Fringes	67
The Lady of Bliss	The Fringes	67
The Silence of the Gods	The Fringes	67
The First of Many	The Fringes	68
Strong and Unified	The Peaks	68
Hells Open	The Peaks	68
Heavens Weep	The Peaks	68
The Road Home	The Peaks	68
For the Living and the Dead	The Peaks	68
Above the Churning Waters	The Peaks	68
The Path Forward	The Peaks	68
With Tired Hands We Toil	The Peaks	68
Where Courage Endures	The Peaks	68
The Price of Freedom	The Peaks	69
Raubahn's Invitation	The Peaks	69
Liberty or Death	The Peaks	69
The Lady in Red	The Peaks	69
Upon the Great Loch's Shore	Rhalgr's Reach	69
The Key to Victory	The Lochs	69
The Resonant	The Lochs	69
The Legacy of Our Fathers	The Lochs	69
The Measure of His Reach	The Lochs	70
Stormblood - 70
Arenvald's Adventure	Rhalgr's Reach	70
The Darkness Below	Rhalgr's Reach	70
The Mad King's Trove	The Lochs	70
The Butcher's Blood	The Lochs	70
Echoes of an Echo	The Lochs	70
A Sultana's Strings	The Lochs	70
A Sultana's Duty	Ul'dah	70
A Sultana's Resolve	The Gold Saucer	70
Securing the Saltery	The Waking Sands	70
A Blissful Arrival	The Lochs	70
Return of the Bull	The Lochs	70
Tidings from the East	Rhalgr's Reach	70
The Sword in the Store	Kugane	70
Hope on the Waves	Kugane	70
Elation and Trepidation	The Ruby Sea	70
Storm on the Horizon	Yanxia	70
His Forgotten Home	The Doman Enclave	70
A Guilty Conscience	Yanxia	70
Rise of a New Sun	Kienkan	70
Gosetsu and Tsuyu	Ruby Bazaar Offices	70
Gone Like the Morning Dew	The Doman Enclave	70
Fruits of Her Labor	Yanxia	70
Conscripts and Contingencies	Kienkan	70
The Primary Agreement	Kienkan	70
Under the Moonlight	Kienkan	70
Emissary of the Dawn	The Rising Stones	70
Sisterly Act	The Rising Stones	70
Feel the Burn	Kienkan	70
Shadows in the Empire	The Doman Enclave	70
A Power in Slumber	Kienkan	70
The Will of the Moon	The Azim Steppe	70
The Call	The Azim Steppe	70
Prelude in Violet	The Lochs	70
 Soul Searching	The Rising Stones	70
 A Defector's Tidings	The Dravanian Hinterlands	70
 Seiryu's Wall	Kienkan	70
 Parley on the Front Lines	Kienkan	70
 The Face of War	Alliance Headquarters	70
 A Brief Reprieve	The Rising Stones	70
 A Requiem for Heroes	The Lochs	70
